############################
#*...........##...........*#
#.####.#####.##.#####.####.#
#.####.#####.##.#####.####.#
#.####.#####.##.#####.####.#
#..........................#
#.####.##.########.##.####.#
#.####.##.########.##.####.#
#*.....##...*##*...##.....*#
######.##### ## #####.######
     #.##### ## #####.#     
     #.##          ##.#     
     #.## ###  ### ##.#     
######.## #      # ##.######
      .   #   g  #   .       
######.## #      # ##.######
     #.## ######## ##.#     
     #.##     p    ##.#     
     #.## ######## ##.#     
######.## ######## ##.######
#*...........##...........*#
#.####.#####.##.#####.####.#
#.####.#####.##.#####.####.#
#...##................##...#
###.##.##.########.##.##.###
###.##.##.########.##.##.###
#*.....##....##....##.....*#
#.##########.##.##########.#
#.##########.##.##########.#
#*........................*#
############################
