###########
#....#....#
#.##.#.##.#
#.##.#.##.#
#.........#
###.###.###
###.....###
   .#.#.   
###.#g#.###
###.###.###
#...p.....#
#.##.#.##.#
#.##.#.##.#
#....#....#
###########