#################################
#...............................#
#.####.......#####........#...#.#
#.#....#####.##..##.#####.#...#.#
#.####.#####.##...#.#####.#...#.#
#....#.#####.##..##.#####.#...#.#
#.####.#####.#####..#####..###..#
#...............................#
#.####.##.############.##.#####.#
#.####.##.############.##.#####.#
#*.....##....######....##......*#
######.##### ###### #####.#######
     #.##### ###### #####.##     
     #.##              ##.##     
     #.## ###      ### ##.##     
######.## #  gggggg  # ##.#######
#     .   # gggggggg #   .      #
######.## #          # ##.#######
     #.## ############ ##.##     
     #.##    pppppp    ##.##     
     #.## ############ ##.##     
######.## ############ ##.#######
#*...........######............*#
#.####.#####.######.#####.#####.#
#.####.#####.######.#####.#####.#
#...##....................###...#
###.##.##.############.##.###.###
###.##.##.############.##.###.###
#......##....######....##.......#
#.##########.######.###########.#
#.##########.######.###########.#
#...............................#
#################################
