############################
#..........................#
#..###...###....###...##...#
#..#.....#.#......#....#...#
#..#.#...###....###....#...#
#..#.#...#......#......#...#
#..###...#......###...###..#
#..........................#
#.####.##.#######.##.#####.#
#.####.##.#######.##.#####.#
#*.....##....#....##......*#
######.##### # #####.#######
     #.##### # #####.##     
     #.##         ##.##     
     #.## ### ### ##.##     
######.## #  g  # ##.#######
#     .   # ggg #   .      #
######.## #     # ##.#######
     #.## ####### ##.##     
     #.##    p    ##.##     
     #.## ####### ##.##     
######.## ####### ##.#######
#*...........#............*#
#.####.#####.#.#####.#####.#
#.####.#####.#.#####.#####.#
#...##...............###...#
###.##.##.#######.##.###.###
###.##.##.#######.##.###.###
#......##....#....##.......#
#.##########.#.###########.#
#.##########.#.###########.#
#..........................#
############################
