#############################
#............###............#
#.####.#####.###.#####.####.#
#.####.#####.###.#####.####.#
#.####.#####.###.#####.####.#
#...........................#
#.####.##.#########.##.####.#
#.####.##.#########.##.####.#
#*.....##....###....##.....*#
######.##### ### #####.######
     #.##### ### #####.#     
     #.##           ##.#     
     #.## ###   ### ##.#     
######.## #  gg   # ##.######
      .   #  gg   #   .       
######.## #       # ##.######
     #.## ######### ##.#     
     #.##     p     ##.#     
     #.## ######### ##.#     
######.## ######### ##.######
#*...........###...........*#
#.####.#####.###.#####.####.#
#.####.#####.###.#####.####.#
#...##.................##...#
###.##.##.#########.##.##.###
###.##.##.#########.##.##.###
#......##....###....##......#
#.##########.###.##########.#
#.##########.###.##########.#
#...........................#
#############################
