############################
#............##............#
#.####.#####.##.#####.####.#
#.####.#####.##.#####.####.#
#.####.#####.##.#####.####.#
#..........................#
#.####.##.########.##.####.#
#.####.##.########.##.####.#
#*.....##....##....##.....*#
######.##### ## #####.######
     #.##### ## #####.#     
     #.##          ##.#     
     #.## ###  ### ##.#     
######.## #  gg  # ##.######
#     .   #  gg  #   .     # 
######.## #      # ##.######
     #.## ######## ##.#     
     #.##     p    ##.#     
     #.## ######## ##.#     
######.## ######## ##.######
#*...........##...........*#
#.####.#####.##.#####.####.#
#.####.#####.##.#####.####.#
#...##................##...#
###.##.##.########.##.##.###
###.##.##.########.##.##.###
#......##....##....##......#
#.##########.##.##########.#
#.##########.##.##########.#
#..........................#
############################
