###########################
#............#............#
#.####.#####.#.#####.####.#
#.####.#####.#.#####.####.#
#.####.#####.#.#####.####.#
#.........................#
#.####.##.#######.##.####.#
#.####.##.#######.##.####.#
#*.....##....#....##.....*#
######.##### # #####.######
     #.##### # #####.#     
     #.##         ##.#     
     #.## ### ### ##.#     
######.## #  g  # ##.######
#     .   # ggg #   .     #
######.## #     # ##.######
     #.## ####### ##.#     
     #.##    p    ##.#     
     #.## ####### ##.#     
######.## ####### ##.######
#*...........#...........*#
#.####.#####.#.#####.####.#
#.####.#####.#.#####.####.#
#...##...............##...#
###.##.##.#######.##.##.###
###.##.##.#######.##.##.###
#......##....#....##......#
#.##########.#.##########.#
#.##########.#.##########.#
#.........................#
###########################
